üé∂ Th√®me : Musique √† Lyon
üèõÔ∏è Lieux embl√©matiques de la musique √† Lyon
Nom	Adresse	Genre principal	Particularit√©
Op√©ra National de Lyon	1 Place de la Com√©die, 69001	Classique, op√©ra, ballet	Direction artistique innovante, r√©nov√© par Jean Nouvel
Auditorium-Orchestre National de Lyon	149 Rue Garibaldi, 69003	Musique symphonique, jazz	Acoustique exceptionnelle, lieu de prestige
Le Transbordeur	3 Bd Stalingrad, 69100 Villeurbanne	Musiques actuelles (rock, √©lectro, rap)	Grande salle (1800 places), programmation internationale
L‚Äô√âpicerie Moderne	Place Ren√© Lescot, 69320 Feyzin	Ind√©, √©lectro, rock	Soutien aux artistes √©mergents
March√© Gare	34 Rue Casimir P√©rier, 69002	Rock, hip-hop, √©lectro, world	Salle underground tr√®s active
Ninkasi Gerland / Kao	267 Rue Marcel M√©rieux, 69007	Vari√© (rap, funk, jazz, techno)	Lieu hybride bar/resto/concerts
Le P√©riscope	13 Rue Delandine, 69002	Jazz, musiques exp√©rimentales	R√©sidences et projets artistiques alternatifs

üé§ Artistes embl√©matiques originaires de Lyon
Nom	Genre	Particularit√©
Jean-Michel Jarre	Musique √©lectronique	Pionnier mondial du synth√©, show monumental √† Lyon (1986)
Benjamin Biolay	Chanson pop	Texte po√©tique et orchestration classe
Vitaa	Pop urbaine / R&B	Connue en solo et avec Slimane
Andr√© Manoukian	Jazz	Figure m√©diatique et promoteur du jazz en France

üåå Artistes √©mergents / sc√®ne actuelle
Nom	Genre	Notes
Menace Santana	Drill / Trap	Membre influent de la sc√®ne drill fr, originaire des Minguettes
So La Lune	Rap m√©lodique / Cloud rap	Flow lunaire, voix autotun√©e identifiable, textes sensibles
Lyonzon (collectif)	Trap / Plugg	Compos√© de Ashe 22, Kpri, Bushi, etc. Sc√®ne tr√®s active et influente
Sasso	Rap / Trap	S√©rie Enfant2larue, disque d‚Äôor, star montante lyonnaise
Tha√Øs Lona	Neo-soul / RnB	Chanteuse montante sur la sc√®ne alternative
Pers√©ide	Rock alternatif	Groupe lyonnais avec une grosse pr√©sence sc√©nique
Eliott Jane, Vannye, Trio SR9, Animali	Pop, √©lectro, classique moderne	Vari√©t√© et √©clectisme musical fort √† Lyon

üéâ Festivals musicaux majeurs
Nom	P√©riode	Style	Particularit√©
Nuits de Fourvi√®re	Juin √† ao√ªt	Tous styles (pop, rock, op√©ra...)	Dans le Th√©√¢tre antique de Fourvi√®re
Nuits Sonores	Mai/Juin	√âlectro, ind√©	R√©f√©rence europ√©enne des festivals √©lectroniques
Woodstower	Ao√ªt	Rap, √©lectro, √©cologie	Festi engag√© au Grand Parc Miribel
Reperkusound	Printemps	Techno, dubstep, bass music	Festival indoor, tr√®s √©nergique
Jazz √† Vienne	Juin-Juillet	Jazz & musiques du monde	√Ä 30min de Lyon, mais culte et international

üöÄ Initiatives de soutien aux jeunes talents
Nom	Description
Sc√®nes D√©couvertes (Ville de Lyon)	R√©seau de salles pour la cr√©ation √©mergente (musique, th√©√¢tre, etc.)
Sc√®nes d‚Äô√âmergence Musicale (Villeurbanne)	Programme d'accompagnement pour jeunes groupes en d√©veloppement
Kiwi Festival	Tremplin musical avec concerts live √† la F√™te de la Musique

üß† Contexte historique et influence
Sc√®ne baroque importante au XVIIIe si√®cle (salons priv√©s, √©glises).

Explosion rock/punk dans les ann√©es 70‚Äì80 (Rock‚Äôn‚ÄôRoll Mops, Wolnitza).

Aujourd‚Äôhui, Lyon est un berceau du rap fran√ßais ind√©pendant et un bastion √©lectronique avec un public fid√®le et curieux.